.................#.#............................................#................#........................................#.......
.....#.............................................................#.......#...#........................#...........#.......##....
..........................................................#..#........#..........#...............#.#..................#...........
..#...#..........#....#.....#......................................#......#..#............................#..#....................
.........................#....#.............#....................................#............................................#...
.....................#.......#.............#...#..........#.................#.......#...............#............#......#.........
........#.........#.....................................#............#.....................##...#..#..........#...................
....#...................#.....##......#............#...#........................#...................................#.............
...............................................................................#.......#.....#...#................#.#......##.....
..........................................#............................#.#.................................#.........#............
........#...............#...............#...................##......#..................#...............#..........................
.........................#....................................#..........#.........................................##.............
.......#.................#..................................#......#....................#...............#..........#......#.......
.............#.#...#.............#.............................................#...............................##.....#...#.......
.....................................................#............................................#.........................#.....
.#...#..........................................................##.................................#............#...............#.
...........#..#........#.....#.............#.......#............................................#..............#.................#
......#.#.##...............#.......#......#......................................................................#...............#
...#........#.#.....................##...#...........................#..............................#...................#.........
..............#..#....................#...................#.................##..............#.#........................#..........
...........................................................#.........#.......................#......................#.........#...
................................................#....................+----------------------+#....................................
..#.....................................................#............|.#...#.........#.....#|.......................#.............
.#..............................#......#..............#..............|......................|..................#..................
#......#.....#..#..#........#....................#...........##......|......................|#..#.....#.....#.....................
.................#.....#.....................#.........#.............|................#.....|........##......................#....
...........................................................#...##....|.........#............|.............#....#..................
........#..#............................#.#........................#.|...#................#.|.#...................................
..........................#........#.................................|......................|..............##...................#.
............#....#.............................................#.....|.#....#.....#.........|..............................#......
..........#............#....#.......................#.#............#.|......................|.....................................
......#...#......................................................#..#|......................|.....................................
.#...#.....#.....#...................................................|......................|...........#..........#.....#........
...#..#..............................................................|..............#.......|.....................................
............#...................#....................................|......#..............#|....#.....................#.##.......
.................................................#...................|......................|.....................................
.........................#.......................................#...|..............#.......|......................#..............
.....................................................................|......................|...................................#.
...#...........................................#........#............|......................|.............#......#................
..#...........................................#.......#.....#........|......................|.#....#.............#...............#
........#..............#.............................................|......................|..............#......................
...........#......#............#............#........................|.........#.........#..|...........#.........#..........#....
.........................#.........#.....#...........................|.....#................|.#...............##..#...............
.....#........#......................................................|..#...................|................#......#....#........
...#..#.......#......#.#..................#..........................|#.....................|.....................................
....................#.#.....................................................................|....#...#............................
...........................#..........................................................#.....|.....................................
................#...........................................................................+..#..................................
...............................#............................................................#...................................#.
..............#..........................................#..............#..................#..........#...........................
................#...#..........................#.##..........#.......#..............................#........#..............#.....
...................#.............#....................#...........................................................................
....#....................................#....#................................................#..#...........#...................
....#.#..............#..........#...................#...................................#....................#........#......#....
...........................#...........#..#......#.......................................#.......................#......#.........
.....................................................................................................#.................#..........
...................................................#.............#..........#..............................#......................
................................#...........##....................................................................#....#..........
...........#.......#.......................................................................#............#.....................#...
.#........#.......#........................................#.#...............................#...#...........................#....
..#...............#................#....#............#................................................................#...........
........#..........#.........#....................................................................................#...............
............................................................................#.............................#...............#......#
......................#................................#.............#...#............#...........................................
................................#.............#.................................................................#..............#..
.........#.#..#...............................#....................................................#.#.......#..#........#........
.............................#.......#.....#......................................................#..#............................
..................#.............................................................................#..........#......................
.....................................#....##.................#......................................#....#........................
#.......................................................................................................................#.........
......#....#..#...........................#..#.....#........................................#..................................#..
.......#.....#...............#....#......#....#..........#.....................#....#..........#.....#..#......................##.
..................#..........#.....#........................................................#............##...................#...
........................#....#............#..................................#....#..#.......#...................................#
.....#............................#...............................#..#...................#.....#..#........#....#.#...............
......#...#..#......#..........................#........#....................#.......#...........#..........................#..#..
.....#.............................................................................................#......#......................#
...........................................#......................................................................................
.....#...........................#.#.#............................#..................#............................#.......#.......
........#.......................................................#...................#.......#.....................................
...............#..................................................#.................................................#.............
..##............................................................#..............................................................#..
.......#..................................#......................#.................................#...................#..........
......#.........#..............#....##........#....#................................#.....................................#......#
................#.....................................................................................#.............#.............
#..#..#......#.#.....#..#.................................................................................................#..#....
.....................#.....#................................................#.......#........#.................#........#.#...#...
..................................................................#....#..#...................#................................#..
........................#...........#.......................................................#..#..................................
.#.......#...................................................#..............#.......#...#.........................................
.......##...............#.............................#...........................#...............................................
....#............#....#...#........................#...........................#.#.....#..........................................
...........................#............................#..#..................#...........................#...#...................
...........#.#.............#..........#...........................................................................................
.............#..........#...............#...##.........................#..............#...#.............#..#......................
..................#.....#............#..#.........#...............................................................................
...........................................................#.....#..................#.......................#..#..................
....................................#....#.......##............#.............................#...............#...........#........
......#....................#..................#..........................................#...............................#.#......
......................#...........................................#.....#.................................................#....#..
.....................................#...............#....................................#.....#.............#......##...........
......................#...............................................................##.#..........#....#..................#.....
...........#.............#......................#....................#..................................#......#...........##.....
.....#.#...#......................................................................................................................
.........#.....................................#................#.............#....#......................#..........#............
......##.#.................#...............#..##.......................#...............#.......................................#..
....................#.........#.......#....#..................................#..........................#..............#.........
......................#....#..#..#................................#.......#.......................................................
.........................................##............................##..#..................#..................#...........#....
...................#..................................#................................................................#..........
.#.............#....................................................................................#.............................
......................................#.....#.............#..#............................................#...#............#......
.....................................#..................................#...#.......................##...................#........
...........................................................#...................................................#...........#......
.............................#.......#.......................................#.........................#.....................#...#
.....................#............................................................................................................
#....#.......................................#.........#........#...................................#.....#.........#........#....
.......................................................#......#................................##.#........#.........#..........#.
.........#........................##.....#.............................................................#.................#..#.....
....##....................................................................................................#...#...#...............
.......#.....#.......#.............#........#...............##.#......#...............#.................#..#.........#...#....#...
....................#.................................#........................................................................#..
#...............#....................................#.........#...............................#..#..........##...#...#......#....
............#........................#.....#...#.........#.........#..#......................................#....................
..........#.......#.#.....................#...........#...................#.##....................#..#...#........#..............#
.......................................#.......#........#.....#...........................................#.......#......#........
...............................#.........#..............#......................#..........................................#.#.....
............#........#.............................................#.....................................................##......#
......#.#............................................................................#......#.....#......#................#.......
.........#.............#................#.................#..###..........#.........................#.#....#......................
